//MAP CONVERTED BY dmm2tgm.py THIS HEADER COMMENT PREVENTS RECONVERSION, DO NOT REMOVE
"wF" = (
/turf/open/space/basic,
/area/space)
"FL" = (
/turf/open/floor/corsat/squares,
/area/space)
"Tf" = (
/turf/closed/wall/r_wall/biodome/biodome_unmeltable,
/area/space)

(1,1,1) = {"
wF
wF
wF
wF
wF
wF
wF
wF
wF
wF
wF
wF
wF
wF
wF
wF
wF
wF
wF
wF
wF
wF
wF
wF
wF
wF
wF
wF
wF
wF
wF
wF
wF
wF
wF
wF
wF
wF
wF
wF
wF
wF
wF
wF
wF
wF
wF
wF
wF
wF
wF
wF
wF
wF
wF
wF
wF
wF
wF
wF
wF
wF
wF
wF
"}
(2,1,1) = {"
wF
wF
wF
wF
wF
wF
wF
wF
wF
wF
wF
wF
wF
wF
wF
wF
wF
wF
wF
wF
wF
wF
wF
wF
wF
wF
wF
wF
wF
wF
wF
wF
wF
wF
wF
wF
wF
wF
wF
wF
wF
wF
wF
wF
wF
wF
wF
wF
wF
wF
wF
wF
wF
wF
wF
wF
wF
wF
wF
wF
wF
wF
wF
wF
"}
(3,1,1) = {"
wF
wF
wF
wF
wF
wF
wF
wF
wF
wF
wF
wF
wF
wF
wF
wF
wF
wF
wF
wF
wF
wF
wF
wF
wF
wF
wF
wF
wF
wF
wF
wF
wF
wF
wF
wF
wF
wF
wF
wF
wF
wF
wF
wF
wF
wF
wF
wF
wF
wF
wF
wF
wF
wF
wF
wF
wF
wF
wF
wF
wF
wF
wF
wF
"}
(4,1,1) = {"
wF
wF
wF
wF
wF
wF
wF
wF
wF
wF
wF
wF
wF
wF
wF
wF
wF
wF
wF
wF
wF
wF
wF
wF
wF
wF
wF
wF
wF
wF
wF
wF
wF
wF
wF
wF
wF
wF
wF
wF
wF
wF
wF
wF
wF
wF
wF
wF
wF
wF
wF
wF
wF
wF
wF
wF
wF
wF
wF
wF
wF
wF
wF
wF
"}
(5,1,1) = {"
wF
wF
wF
wF
wF
wF
wF
wF
wF
wF
wF
wF
wF
wF
wF
wF
wF
wF
wF
wF
wF
wF
wF
wF
wF
wF
wF
wF
wF
wF
wF
wF
wF
wF
wF
wF
wF
wF
wF
wF
wF
wF
wF
wF
wF
wF
wF
wF
wF
wF
wF
wF
wF
wF
wF
wF
wF
wF
wF
wF
wF
wF
wF
wF
"}
(6,1,1) = {"
wF
wF
wF
wF
wF
wF
wF
wF
wF
wF
wF
wF
wF
wF
wF
wF
wF
wF
wF
wF
wF
wF
wF
wF
wF
wF
wF
wF
wF
wF
wF
wF
wF
wF
wF
wF
wF
wF
wF
wF
wF
wF
wF
wF
wF
wF
wF
wF
wF
wF
wF
wF
wF
wF
wF
wF
wF
wF
wF
wF
wF
wF
wF
wF
"}
(7,1,1) = {"
wF
wF
wF
wF
wF
wF
wF
wF
wF
wF
wF
wF
wF
wF
wF
wF
wF
wF
wF
wF
wF
wF
wF
wF
wF
wF
wF
wF
wF
wF
wF
wF
wF
wF
wF
wF
wF
wF
wF
wF
wF
wF
wF
wF
wF
wF
wF
wF
wF
wF
wF
wF
wF
wF
wF
wF
wF
wF
wF
wF
wF
wF
wF
wF
"}
(8,1,1) = {"
wF
wF
wF
wF
wF
wF
wF
wF
wF
wF
wF
wF
wF
wF
wF
wF
wF
wF
wF
wF
wF
wF
wF
wF
wF
wF
wF
Tf
Tf
Tf
Tf
Tf
Tf
Tf
Tf
Tf
Tf
wF
wF
wF
wF
wF
wF
wF
wF
wF
wF
wF
wF
wF
wF
wF
wF
wF
wF
wF
wF
wF
wF
wF
wF
wF
wF
wF
"}
(9,1,1) = {"
wF
wF
wF
wF
wF
wF
wF
wF
wF
wF
wF
wF
wF
wF
wF
wF
wF
wF
wF
wF
wF
wF
wF
Tf
Tf
Tf
Tf
Tf
FL
FL
FL
FL
FL
FL
FL
FL
Tf
Tf
Tf
Tf
Tf
wF
wF
wF
wF
wF
wF
wF
wF
wF
wF
wF
wF
wF
wF
wF
wF
wF
wF
wF
wF
wF
wF
wF
"}
(10,1,1) = {"
wF
wF
wF
wF
wF
wF
wF
wF
wF
wF
wF
wF
wF
wF
wF
wF
wF
wF
wF
wF
wF
Tf
Tf
Tf
FL
FL
FL
FL
FL
FL
FL
FL
FL
FL
FL
FL
FL
FL
FL
FL
Tf
Tf
Tf
wF
wF
wF
wF
wF
wF
wF
wF
wF
wF
wF
wF
wF
wF
wF
wF
wF
wF
wF
wF
wF
"}
(11,1,1) = {"
wF
wF
wF
wF
wF
wF
wF
wF
wF
wF
wF
wF
wF
wF
wF
wF
wF
wF
wF
Tf
Tf
Tf
FL
FL
FL
FL
FL
FL
FL
FL
FL
FL
FL
FL
FL
FL
FL
FL
FL
FL
FL
FL
Tf
Tf
Tf
wF
wF
wF
wF
wF
wF
wF
wF
wF
wF
wF
wF
wF
wF
wF
wF
wF
wF
wF
"}
(12,1,1) = {"
wF
wF
wF
wF
wF
wF
wF
wF
wF
wF
wF
wF
wF
wF
wF
wF
wF
wF
Tf
Tf
FL
FL
FL
FL
FL
FL
FL
FL
FL
FL
FL
FL
FL
FL
FL
FL
FL
FL
FL
FL
FL
FL
FL
FL
Tf
Tf
wF
wF
wF
wF
wF
wF
wF
wF
wF
wF
wF
wF
wF
wF
wF
wF
wF
wF
"}
(13,1,1) = {"
wF
wF
wF
wF
wF
wF
wF
wF
wF
wF
wF
wF
wF
wF
wF
wF
Tf
Tf
FL
FL
FL
FL
FL
FL
FL
FL
FL
FL
FL
FL
FL
FL
FL
FL
FL
FL
FL
FL
FL
FL
FL
FL
FL
FL
FL
Tf
Tf
Tf
wF
wF
wF
wF
wF
wF
wF
wF
wF
wF
wF
wF
wF
wF
wF
wF
"}
(14,1,1) = {"
wF
wF
wF
wF
wF
wF
wF
wF
wF
wF
wF
wF
wF
wF
wF
Tf
Tf
FL
FL
FL
FL
FL
FL
FL
FL
FL
FL
FL
FL
FL
FL
FL
FL
FL
FL
FL
FL
FL
FL
FL
FL
FL
FL
FL
FL
FL
FL
Tf
Tf
wF
wF
wF
wF
wF
wF
wF
wF
wF
wF
wF
wF
wF
wF
wF
"}
(15,1,1) = {"
wF
wF
wF
wF
wF
wF
wF
wF
wF
wF
wF
wF
wF
wF
Tf
Tf
FL
FL
FL
FL
FL
FL
FL
FL
FL
FL
FL
FL
FL
FL
FL
FL
FL
FL
FL
FL
FL
FL
FL
FL
FL
FL
FL
FL
FL
FL
FL
FL
Tf
Tf
wF
wF
wF
wF
wF
wF
wF
wF
wF
wF
wF
wF
wF
wF
"}
(16,1,1) = {"
wF
wF
wF
wF
wF
wF
wF
wF
wF
wF
wF
wF
wF
Tf
Tf
FL
FL
FL
FL
FL
FL
FL
FL
FL
FL
FL
FL
FL
FL
FL
FL
FL
FL
FL
FL
FL
FL
FL
FL
FL
FL
FL
FL
FL
FL
FL
FL
FL
FL
Tf
Tf
wF
wF
wF
wF
wF
wF
wF
wF
wF
wF
wF
wF
wF
"}
(17,1,1) = {"
wF
wF
wF
wF
wF
wF
wF
wF
wF
wF
wF
wF
Tf
Tf
FL
FL
FL
FL
FL
FL
FL
FL
FL
FL
FL
FL
FL
FL
FL
FL
FL
FL
FL
FL
FL
FL
FL
FL
FL
FL
FL
FL
FL
FL
FL
FL
FL
FL
FL
FL
Tf
Tf
wF
wF
wF
wF
wF
wF
wF
wF
wF
wF
wF
wF
"}
(18,1,1) = {"
wF
wF
wF
wF
wF
wF
wF
wF
wF
wF
wF
wF
Tf
FL
FL
FL
FL
FL
FL
FL
FL
FL
FL
FL
FL
FL
FL
FL
FL
FL
FL
FL
FL
FL
FL
FL
FL
FL
FL
FL
FL
FL
FL
FL
FL
FL
FL
FL
FL
FL
FL
Tf
wF
wF
wF
wF
wF
wF
wF
wF
wF
wF
wF
wF
"}
(19,1,1) = {"
wF
wF
wF
wF
wF
wF
wF
wF
wF
wF
wF
Tf
Tf
FL
FL
FL
FL
FL
FL
FL
FL
FL
FL
FL
FL
FL
FL
FL
FL
FL
FL
FL
FL
FL
FL
FL
FL
FL
FL
FL
FL
FL
FL
FL
FL
FL
FL
FL
FL
FL
FL
Tf
Tf
wF
wF
wF
wF
wF
wF
wF
wF
wF
wF
wF
"}
(20,1,1) = {"
wF
wF
wF
wF
wF
wF
wF
wF
wF
wF
Tf
Tf
FL
FL
FL
FL
FL
FL
FL
FL
FL
FL
FL
FL
FL
FL
FL
FL
FL
FL
FL
FL
FL
FL
FL
FL
FL
FL
FL
FL
FL
FL
FL
FL
FL
FL
FL
FL
FL
FL
FL
FL
Tf
Tf
wF
wF
wF
wF
wF
wF
wF
wF
wF
wF
"}
(21,1,1) = {"
wF
wF
wF
wF
wF
wF
wF
wF
wF
wF
Tf
FL
FL
FL
FL
FL
FL
FL
FL
FL
FL
FL
FL
FL
FL
FL
FL
FL
FL
FL
FL
FL
FL
FL
FL
FL
FL
FL
FL
FL
FL
FL
FL
FL
FL
FL
FL
FL
FL
FL
FL
FL
FL
Tf
wF
wF
wF
wF
wF
wF
wF
wF
wF
wF
"}
(22,1,1) = {"
wF
wF
wF
wF
wF
wF
wF
wF
wF
Tf
Tf
FL
FL
FL
FL
FL
FL
FL
FL
FL
FL
FL
FL
FL
FL
FL
FL
FL
FL
FL
FL
FL
FL
FL
FL
FL
FL
FL
FL
FL
FL
FL
FL
FL
FL
FL
FL
FL
FL
FL
FL
FL
FL
FL
Tf
wF
wF
wF
wF
wF
wF
wF
wF
wF
"}
(23,1,1) = {"
wF
wF
wF
wF
wF
wF
wF
wF
wF
Tf
FL
FL
FL
FL
FL
FL
FL
FL
FL
FL
FL
FL
FL
FL
FL
FL
FL
FL
FL
FL
FL
FL
FL
FL
FL
FL
FL
FL
FL
FL
FL
FL
FL
FL
FL
FL
FL
FL
FL
FL
FL
FL
FL
FL
Tf
wF
wF
wF
wF
wF
wF
wF
wF
wF
"}
(24,1,1) = {"
wF
wF
wF
wF
wF
wF
wF
wF
Tf
Tf
FL
FL
FL
FL
FL
FL
FL
FL
FL
FL
FL
FL
FL
FL
FL
FL
FL
FL
FL
FL
FL
FL
FL
FL
FL
FL
FL
FL
FL
FL
FL
FL
FL
FL
FL
FL
FL
FL
FL
FL
FL
FL
FL
FL
Tf
Tf
wF
wF
wF
wF
wF
wF
wF
wF
"}
(25,1,1) = {"
wF
wF
wF
wF
wF
wF
wF
wF
Tf
FL
FL
FL
FL
FL
FL
FL
FL
FL
FL
FL
FL
FL
FL
FL
FL
FL
FL
FL
FL
FL
FL
FL
FL
FL
FL
FL
FL
FL
FL
FL
FL
FL
FL
FL
FL
FL
FL
FL
FL
FL
FL
FL
FL
FL
FL
Tf
wF
wF
wF
wF
wF
wF
wF
wF
"}
(26,1,1) = {"
wF
wF
wF
wF
wF
wF
wF
wF
Tf
FL
FL
FL
FL
FL
FL
FL
FL
FL
FL
FL
FL
FL
FL
FL
FL
FL
FL
FL
FL
FL
FL
FL
FL
FL
FL
FL
FL
FL
FL
FL
FL
FL
FL
FL
FL
FL
FL
FL
FL
FL
FL
FL
FL
FL
FL
Tf
wF
wF
wF
wF
wF
wF
wF
wF
"}
(27,1,1) = {"
wF
wF
wF
wF
wF
wF
wF
wF
Tf
FL
FL
FL
FL
FL
FL
FL
FL
FL
FL
FL
FL
FL
FL
FL
FL
FL
FL
FL
FL
FL
FL
FL
FL
FL
FL
FL
FL
FL
FL
FL
FL
FL
FL
FL
FL
FL
FL
FL
FL
FL
FL
FL
FL
FL
FL
Tf
wF
wF
wF
wF
wF
wF
wF
wF
"}
(28,1,1) = {"
wF
wF
wF
wF
wF
wF
wF
Tf
Tf
FL
FL
FL
FL
FL
FL
FL
FL
FL
FL
FL
FL
FL
FL
FL
FL
FL
FL
FL
FL
FL
FL
FL
FL
FL
FL
FL
FL
FL
FL
FL
FL
FL
FL
FL
FL
FL
FL
FL
FL
FL
FL
FL
FL
FL
FL
Tf
Tf
wF
wF
wF
wF
wF
wF
wF
"}
(29,1,1) = {"
wF
wF
wF
wF
wF
wF
wF
Tf
FL
FL
FL
FL
FL
FL
FL
FL
FL
FL
FL
FL
FL
FL
FL
FL
FL
FL
FL
FL
FL
FL
FL
FL
FL
FL
FL
FL
FL
FL
FL
FL
FL
FL
FL
FL
FL
FL
FL
FL
FL
FL
FL
FL
FL
FL
FL
FL
Tf
wF
wF
wF
wF
wF
wF
wF
"}
(30,1,1) = {"
wF
wF
wF
wF
wF
wF
wF
Tf
FL
FL
FL
FL
FL
FL
FL
FL
FL
FL
FL
FL
FL
FL
FL
FL
FL
FL
FL
FL
FL
FL
FL
FL
FL
FL
FL
FL
FL
FL
FL
FL
FL
FL
FL
FL
FL
FL
FL
FL
FL
FL
FL
FL
FL
FL
FL
FL
Tf
wF
wF
wF
wF
wF
wF
wF
"}
(31,1,1) = {"
wF
wF
wF
wF
wF
wF
wF
Tf
FL
FL
FL
FL
FL
FL
FL
FL
FL
FL
FL
FL
FL
FL
FL
FL
FL
FL
FL
FL
FL
FL
FL
FL
FL
FL
FL
FL
FL
FL
FL
FL
FL
FL
FL
FL
FL
FL
FL
FL
FL
FL
FL
FL
FL
FL
FL
FL
Tf
wF
wF
wF
wF
wF
wF
wF
"}
(32,1,1) = {"
wF
wF
wF
wF
wF
wF
wF
Tf
FL
FL
FL
FL
FL
FL
FL
FL
FL
FL
FL
FL
FL
FL
FL
FL
FL
FL
FL
FL
FL
FL
FL
FL
FL
FL
FL
FL
FL
FL
FL
FL
FL
FL
FL
FL
FL
FL
FL
FL
FL
FL
FL
FL
FL
FL
FL
FL
Tf
wF
wF
wF
wF
wF
wF
wF
"}
(33,1,1) = {"
wF
wF
wF
wF
wF
wF
wF
Tf
FL
FL
FL
FL
FL
FL
FL
FL
FL
FL
FL
FL
FL
FL
FL
FL
FL
FL
FL
FL
FL
FL
FL
FL
FL
FL
FL
FL
FL
FL
FL
FL
FL
FL
FL
FL
FL
FL
FL
FL
FL
FL
FL
FL
FL
FL
FL
FL
Tf
wF
wF
wF
wF
wF
wF
wF
"}
(34,1,1) = {"
wF
wF
wF
wF
wF
wF
wF
Tf
FL
FL
FL
FL
FL
FL
FL
FL
FL
FL
FL
FL
FL
FL
FL
FL
FL
FL
FL
FL
FL
FL
FL
FL
FL
FL
FL
FL
FL
FL
FL
FL
FL
FL
FL
FL
FL
FL
FL
FL
FL
FL
FL
FL
FL
FL
FL
FL
Tf
wF
wF
wF
wF
wF
wF
wF
"}
(35,1,1) = {"
wF
wF
wF
wF
wF
wF
wF
Tf
FL
FL
FL
FL
FL
FL
FL
FL
FL
FL
FL
FL
FL
FL
FL
FL
FL
FL
FL
FL
FL
FL
FL
FL
FL
FL
FL
FL
FL
FL
FL
FL
FL
FL
FL
FL
FL
FL
FL
FL
FL
FL
FL
FL
FL
FL
FL
FL
Tf
wF
wF
wF
wF
wF
wF
wF
"}
(36,1,1) = {"
wF
wF
wF
wF
wF
wF
wF
Tf
FL
FL
FL
FL
FL
FL
FL
FL
FL
FL
FL
FL
FL
FL
FL
FL
FL
FL
FL
FL
FL
FL
FL
FL
FL
FL
FL
FL
FL
FL
FL
FL
FL
FL
FL
FL
FL
FL
FL
FL
FL
FL
FL
FL
FL
FL
FL
FL
Tf
wF
wF
wF
wF
wF
wF
wF
"}
(37,1,1) = {"
wF
wF
wF
wF
wF
wF
wF
Tf
Tf
FL
FL
FL
FL
FL
FL
FL
FL
FL
FL
FL
FL
FL
FL
FL
FL
FL
FL
FL
FL
FL
FL
FL
FL
FL
FL
FL
FL
FL
FL
FL
FL
FL
FL
FL
FL
FL
FL
FL
FL
FL
FL
FL
FL
FL
FL
Tf
Tf
wF
wF
wF
wF
wF
wF
wF
"}
(38,1,1) = {"
wF
wF
wF
wF
wF
wF
wF
wF
Tf
FL
FL
FL
FL
FL
FL
FL
FL
FL
FL
FL
FL
FL
FL
FL
FL
FL
FL
FL
FL
FL
FL
FL
FL
FL
FL
FL
FL
FL
FL
FL
FL
FL
FL
FL
FL
FL
FL
FL
FL
FL
FL
FL
FL
FL
FL
Tf
wF
wF
wF
wF
wF
wF
wF
wF
"}
(39,1,1) = {"
wF
wF
wF
wF
wF
wF
wF
wF
Tf
FL
FL
FL
FL
FL
FL
FL
FL
FL
FL
FL
FL
FL
FL
FL
FL
FL
FL
FL
FL
FL
FL
FL
FL
FL
FL
FL
FL
FL
FL
FL
FL
FL
FL
FL
FL
FL
FL
FL
FL
FL
FL
FL
FL
FL
FL
Tf
wF
wF
wF
wF
wF
wF
wF
wF
"}
(40,1,1) = {"
wF
wF
wF
wF
wF
wF
wF
wF
Tf
FL
FL
FL
FL
FL
FL
FL
FL
FL
FL
FL
FL
FL
FL
FL
FL
FL
FL
FL
FL
FL
FL
FL
FL
FL
FL
FL
FL
FL
FL
FL
FL
FL
FL
FL
FL
FL
FL
FL
FL
FL
FL
FL
FL
FL
FL
Tf
wF
wF
wF
wF
wF
wF
wF
wF
"}
(41,1,1) = {"
wF
wF
wF
wF
wF
wF
wF
wF
Tf
Tf
FL
FL
FL
FL
FL
FL
FL
FL
FL
FL
FL
FL
FL
FL
FL
FL
FL
FL
FL
FL
FL
FL
FL
FL
FL
FL
FL
FL
FL
FL
FL
FL
FL
FL
FL
FL
FL
FL
FL
FL
FL
FL
FL
FL
Tf
Tf
wF
wF
wF
wF
wF
wF
wF
wF
"}
(42,1,1) = {"
wF
wF
wF
wF
wF
wF
wF
wF
wF
Tf
FL
FL
FL
FL
FL
FL
FL
FL
FL
FL
FL
FL
FL
FL
FL
FL
FL
FL
FL
FL
FL
FL
FL
FL
FL
FL
FL
FL
FL
FL
FL
FL
FL
FL
FL
FL
FL
FL
FL
FL
FL
FL
FL
FL
Tf
wF
wF
wF
wF
wF
wF
wF
wF
wF
"}
(43,1,1) = {"
wF
wF
wF
wF
wF
wF
wF
wF
wF
Tf
Tf
FL
FL
FL
FL
FL
FL
FL
FL
FL
FL
FL
FL
FL
FL
FL
FL
FL
FL
FL
FL
FL
FL
FL
FL
FL
FL
FL
FL
FL
FL
FL
FL
FL
FL
FL
FL
FL
FL
FL
FL
FL
FL
Tf
Tf
wF
wF
wF
wF
wF
wF
wF
wF
wF
"}
(44,1,1) = {"
wF
wF
wF
wF
wF
wF
wF
wF
wF
wF
Tf
FL
FL
FL
FL
FL
FL
FL
FL
FL
FL
FL
FL
FL
FL
FL
FL
FL
FL
FL
FL
FL
FL
FL
FL
FL
FL
FL
FL
FL
FL
FL
FL
FL
FL
FL
FL
FL
FL
FL
FL
FL
FL
Tf
wF
wF
wF
wF
wF
wF
wF
wF
wF
wF
"}
(45,1,1) = {"
wF
wF
wF
wF
wF
wF
wF
wF
wF
wF
Tf
Tf
FL
FL
FL
FL
FL
FL
FL
FL
FL
FL
FL
FL
FL
FL
FL
FL
FL
FL
FL
FL
FL
FL
FL
FL
FL
FL
FL
FL
FL
FL
FL
FL
FL
FL
FL
FL
FL
FL
FL
FL
Tf
Tf
wF
wF
wF
wF
wF
wF
wF
wF
wF
wF
"}
(46,1,1) = {"
wF
wF
wF
wF
wF
wF
wF
wF
wF
wF
wF
Tf
Tf
FL
FL
FL
FL
FL
FL
FL
FL
FL
FL
FL
FL
FL
FL
FL
FL
FL
FL
FL
FL
FL
FL
FL
FL
FL
FL
FL
FL
FL
FL
FL
FL
FL
FL
FL
FL
FL
FL
Tf
Tf
wF
wF
wF
wF
wF
wF
wF
wF
wF
wF
wF
"}
(47,1,1) = {"
wF
wF
wF
wF
wF
wF
wF
wF
wF
wF
wF
wF
Tf
FL
FL
FL
FL
FL
FL
FL
FL
FL
FL
FL
FL
FL
FL
FL
FL
FL
FL
FL
FL
FL
FL
FL
FL
FL
FL
FL
FL
FL
FL
FL
FL
FL
FL
FL
FL
FL
FL
Tf
wF
wF
wF
wF
wF
wF
wF
wF
wF
wF
wF
wF
"}
(48,1,1) = {"
wF
wF
wF
wF
wF
wF
wF
wF
wF
wF
wF
wF
Tf
Tf
FL
FL
FL
FL
FL
FL
FL
FL
FL
FL
FL
FL
FL
FL
FL
FL
FL
FL
FL
FL
FL
FL
FL
FL
FL
FL
FL
FL
FL
FL
FL
FL
FL
FL
FL
FL
Tf
Tf
wF
wF
wF
wF
wF
wF
wF
wF
wF
wF
wF
wF
"}
(49,1,1) = {"
wF
wF
wF
wF
wF
wF
wF
wF
wF
wF
wF
wF
wF
Tf
Tf
FL
FL
FL
FL
FL
FL
FL
FL
FL
FL
FL
FL
FL
FL
FL
FL
FL
FL
FL
FL
FL
FL
FL
FL
FL
FL
FL
FL
FL
FL
FL
FL
FL
FL
Tf
Tf
wF
wF
wF
wF
wF
wF
wF
wF
wF
wF
wF
wF
wF
"}
(50,1,1) = {"
wF
wF
wF
wF
wF
wF
wF
wF
wF
wF
wF
wF
wF
wF
Tf
Tf
FL
FL
FL
FL
FL
FL
FL
FL
FL
FL
FL
FL
FL
FL
FL
FL
FL
FL
FL
FL
FL
FL
FL
FL
FL
FL
FL
FL
FL
FL
FL
FL
Tf
Tf
wF
wF
wF
wF
wF
wF
wF
wF
wF
wF
wF
wF
wF
wF
"}
(51,1,1) = {"
wF
wF
wF
wF
wF
wF
wF
wF
wF
wF
wF
wF
wF
wF
wF
Tf
Tf
FL
FL
FL
FL
FL
FL
FL
FL
FL
FL
FL
FL
FL
FL
FL
FL
FL
FL
FL
FL
FL
FL
FL
FL
FL
FL
FL
FL
FL
FL
Tf
Tf
wF
wF
wF
wF
wF
wF
wF
wF
wF
wF
wF
wF
wF
wF
wF
"}
(52,1,1) = {"
wF
wF
wF
wF
wF
wF
wF
wF
wF
wF
wF
wF
wF
wF
wF
wF
Tf
Tf
Tf
FL
FL
FL
FL
FL
FL
FL
FL
FL
FL
FL
FL
FL
FL
FL
FL
FL
FL
FL
FL
FL
FL
FL
FL
FL
FL
FL
Tf
Tf
wF
wF
wF
wF
wF
wF
wF
wF
wF
wF
wF
wF
wF
wF
wF
wF
"}
(53,1,1) = {"
wF
wF
wF
wF
wF
wF
wF
wF
wF
wF
wF
wF
wF
wF
wF
wF
wF
wF
Tf
Tf
FL
FL
FL
FL
FL
FL
FL
FL
FL
FL
FL
FL
FL
FL
FL
FL
FL
FL
FL
FL
FL
FL
FL
FL
Tf
Tf
wF
wF
wF
wF
wF
wF
wF
wF
wF
wF
wF
wF
wF
wF
wF
wF
wF
wF
"}
(54,1,1) = {"
wF
wF
wF
wF
wF
wF
wF
wF
wF
wF
wF
wF
wF
wF
wF
wF
wF
wF
wF
Tf
Tf
Tf
FL
FL
FL
FL
FL
FL
FL
FL
FL
FL
FL
FL
FL
FL
FL
FL
FL
FL
FL
FL
Tf
Tf
Tf
wF
wF
wF
wF
wF
wF
wF
wF
wF
wF
wF
wF
wF
wF
wF
wF
wF
wF
wF
"}
(55,1,1) = {"
wF
wF
wF
wF
wF
wF
wF
wF
wF
wF
wF
wF
wF
wF
wF
wF
wF
wF
wF
wF
wF
Tf
Tf
Tf
FL
FL
FL
FL
FL
FL
FL
FL
FL
FL
FL
FL
FL
FL
FL
FL
Tf
Tf
Tf
wF
wF
wF
wF
wF
wF
wF
wF
wF
wF
wF
wF
wF
wF
wF
wF
wF
wF
wF
wF
wF
"}
(56,1,1) = {"
wF
wF
wF
wF
wF
wF
wF
wF
wF
wF
wF
wF
wF
wF
wF
wF
wF
wF
wF
wF
wF
wF
wF
Tf
Tf
Tf
Tf
Tf
FL
FL
FL
FL
FL
FL
FL
FL
Tf
Tf
Tf
Tf
Tf
wF
wF
wF
wF
wF
wF
wF
wF
wF
wF
wF
wF
wF
wF
wF
wF
wF
wF
wF
wF
wF
wF
wF
"}
(57,1,1) = {"
wF
wF
wF
wF
wF
wF
wF
wF
wF
wF
wF
wF
wF
wF
wF
wF
wF
wF
wF
wF
wF
wF
wF
wF
wF
wF
wF
Tf
Tf
Tf
Tf
Tf
Tf
Tf
Tf
Tf
Tf
wF
wF
wF
wF
wF
wF
wF
wF
wF
wF
wF
wF
wF
wF
wF
wF
wF
wF
wF
wF
wF
wF
wF
wF
wF
wF
wF
"}
(58,1,1) = {"
wF
wF
wF
wF
wF
wF
wF
wF
wF
wF
wF
wF
wF
wF
wF
wF
wF
wF
wF
wF
wF
wF
wF
wF
wF
wF
wF
wF
wF
wF
wF
wF
wF
wF
wF
wF
wF
wF
wF
wF
wF
wF
wF
wF
wF
wF
wF
wF
wF
wF
wF
wF
wF
wF
wF
wF
wF
wF
wF
wF
wF
wF
wF
wF
"}
(59,1,1) = {"
wF
wF
wF
wF
wF
wF
wF
wF
wF
wF
wF
wF
wF
wF
wF
wF
wF
wF
wF
wF
wF
wF
wF
wF
wF
wF
wF
wF
wF
wF
wF
wF
wF
wF
wF
wF
wF
wF
wF
wF
wF
wF
wF
wF
wF
wF
wF
wF
wF
wF
wF
wF
wF
wF
wF
wF
wF
wF
wF
wF
wF
wF
wF
wF
"}
(60,1,1) = {"
wF
wF
wF
wF
wF
wF
wF
wF
wF
wF
wF
wF
wF
wF
wF
wF
wF
wF
wF
wF
wF
wF
wF
wF
wF
wF
wF
wF
wF
wF
wF
wF
wF
wF
wF
wF
wF
wF
wF
wF
wF
wF
wF
wF
wF
wF
wF
wF
wF
wF
wF
wF
wF
wF
wF
wF
wF
wF
wF
wF
wF
wF
wF
wF
"}
(61,1,1) = {"
wF
wF
wF
wF
wF
wF
wF
wF
wF
wF
wF
wF
wF
wF
wF
wF
wF
wF
wF
wF
wF
wF
wF
wF
wF
wF
wF
wF
wF
wF
wF
wF
wF
wF
wF
wF
wF
wF
wF
wF
wF
wF
wF
wF
wF
wF
wF
wF
wF
wF
wF
wF
wF
wF
wF
wF
wF
wF
wF
wF
wF
wF
wF
wF
"}
(62,1,1) = {"
wF
wF
wF
wF
wF
wF
wF
wF
wF
wF
wF
wF
wF
wF
wF
wF
wF
wF
wF
wF
wF
wF
wF
wF
wF
wF
wF
wF
wF
wF
wF
wF
wF
wF
wF
wF
wF
wF
wF
wF
wF
wF
wF
wF
wF
wF
wF
wF
wF
wF
wF
wF
wF
wF
wF
wF
wF
wF
wF
wF
wF
wF
wF
wF
"}
(63,1,1) = {"
wF
wF
wF
wF
wF
wF
wF
wF
wF
wF
wF
wF
wF
wF
wF
wF
wF
wF
wF
wF
wF
wF
wF
wF
wF
wF
wF
wF
wF
wF
wF
wF
wF
wF
wF
wF
wF
wF
wF
wF
wF
wF
wF
wF
wF
wF
wF
wF
wF
wF
wF
wF
wF
wF
wF
wF
wF
wF
wF
wF
wF
wF
wF
wF
"}
(64,1,1) = {"
wF
wF
wF
wF
wF
wF
wF
wF
wF
wF
wF
wF
wF
wF
wF
wF
wF
wF
wF
wF
wF
wF
wF
wF
wF
wF
wF
wF
wF
wF
wF
wF
wF
wF
wF
wF
wF
wF
wF
wF
wF
wF
wF
wF
wF
wF
wF
wF
wF
wF
wF
wF
wF
wF
wF
wF
wF
wF
wF
wF
wF
wF
wF
wF
"}
